1111111111111111111
1000010000000100001
1011010111110101101
1000000000000000001
1101011101011101011
1101000001000001011
1101110111110111011
1100000000000000011
1101110111110111011
1101000111110001011
1100010000000100011
1101111101011111011
1100000001000000011
1101110111110111011
1000000000000000001
1011011101011101101
1011010001000101101
1011010111110101101
1000000000000000001
1111111111111111111
